**************************************************
********************        **********************
********************        **********************
********************        **********************
***********                           ************
***********                           ************
*                                               **
*                                               **
*                                               **
*            **********************             **
*            **********************             **
*            **********************             **
*            **********************             **
*                                               **
*                                               **
*                                               **
*****            **************           ********
************                         *************
*****                                    *********
**************************************************
